{
  "map": [
    "#############################",
    "#S#...#...#......~~~~~~..#EE#",
    "#.#.#.#.#.#.~~~~~~~~~~~..#EE#",
    "#.#.#.#.#.#.~~.~~~~~~~~..#..#",
    "#.#.#.#.#.#.~.........~c.#..#",
    "#.#.#.#.#.#.~~~~~~~~.~~..#..#",
    "#.#.#.#.#.#.~~~~~~~~.~~..#..#",
    "#...#...#...~~~~~~~~..~.....#",
    "#############################"
  ],
  "tick_delay_ms": 30,
  "total_ticks": 4500,
  "script_path": "scripts/harvester.lua",
  "view_range": 50,
  "harvest_rate": 10,
  "source_regen_rate": 1,
  "max_source_amount": 1000,
  "spawn_initial_energy": 300,
  "source_initial_amount": 1000
}
